$$$ exec p1 : glebouch.filler
Plateau 24 40:
	0123456789012345678901234567890123456789
000 OOOOOOOOOOOOOOOOOOOOOOXXXXXXXXXXXXXXXXXX
001 OOOOOOOOOOOOOOOOOOOOOXXXXXXXXXXXXXXXXXXX
002 OOOOOOOOOOOOOOOOOOOOXXXXXXXXXXXXXXXXXXXX
003 OOOOOOOOOOOOOOOOOOXXXXXXXXXXXXXXXXXXXXXX
004 OOOOOOOOOOOOOOOOXXXXXXXXXXXXXXXXXXXXXXXX
005 OOOOOOOOOOOOOOOOXXXXXXXXXXXXXXXXXXXXXXXX
006 OOOOOOOOOOOOXXXXXXXXXXXXXXXXXXXXXXXXXXXX
007 OOOOOOOOOOOOOOOXXXXXXXXXXXXXXXXXXXXXXXXX
008 OOOOOOOOOOOOOOOOOXXXXXXXXXXXXXXXXXXXXXXX
009 OOOOOOOOOOOOOOXXXXXXXXXXXXXXXXXXXXXXXXXX
010 OOOOOOOOOOOOOXXXXXXXXXXXXXXXXXXXXXXXXXXX
011 OOOOOOOOOOOOOXXXXXXXXXXXXXXXXXXXXXXXXXXX
012 OOOOOOOOOOOOOXXXXXXXXXXXXXXXXXXXXXXXXXXX
013 OOOOOOOOOOOOOXXXXXXXXXXXXXXXXXXXXXXXXXXX
014 OOOOOOOOOOOOOXXXXXXXXXXXXXXXXXXXXXXXXXXX
015 OOOOOOOOOOOOOXOOXXXXXXXXXXXXXXXXXXXXXXXX
016 OOOOOOOOOOOOOOOOXXXXXXXXXXXXXXXXXXXXXXXX
017 OOOOOOOOOOOOOOOOOXXXXXX.XOOOOXXXXXXXXXX.
018 OOOOOOOOOOOOOOOOOOXXXXXXOOOOXXXXXXXXXXXX
019 OOOOOOOOOOOOOOOOOOOOOOOOOOOOXXXXXXXXXXX.
020 OOOOOOOOOOOOOOOOOOOOOOOOOOOOXXXXXx.XXXX.
021 OOOOOOOOOOOOOOOOOOOOOOOOOOOOXXXX.xxX..X.
022 OOOOOOOOOOOOOOO..OOOOO....OOOOXXxxxXX...
023 OOO....O.....O...........OOOOXXX........
Piece 3 5:
**...
***..
.*... 
